Complexity - Сложность
Futility - Бесполезность
entry level - начальный уровень
control - элемент управления (параметр?)
high-end - элитный
high-end laptop - высокопроизводительный ноутбук
dissimilar - непохожий
suite - набор
test suite - набор тестов (тестирование)
Then again - Опять же,
server farm - группа серверов
distribute - распределение
unreasonable - необоснованный
Validating - Проверка
to evaluate - оценивать
adjusted  - скорректированный 
relative - сравнительный, соответственный
custom software - специализированное программное обеспечение
applicable - применимый
particular customer - конкретный клиент 
inspection system - система проверки
maintaining, maintenance - поддержание, обслуживание 
so general - настолько универсальный
revenue - доход
to justify - оправдать
The bottom line - Суть
to afford - предоставлять
exhaustively - исчерпывающе
shareholders - акционеры
mis-priced items - неправильная цена товаров
invalid combinations of features - недопустимые комбинации особенностей
vehicle - средство
to attend - присутствовать 
exceeds - превышает
likelihood - вероятность
manifesting - проявление
bug - ошибка
less likely - менее вероятно 
inclined - склонный
Don't appreciate the complexities of something - не понимать сложности чего-то
to demand - требовать
lack of appreciation - непонимание
sufficiently - достаточно
brethren - собратья
urge - побуждение, желание
sampling - выборка
Pairwise - Попарно
approach - подход
